|##################################################################################################|
|                                                                                                  |
|                                                                                                  |
|                                                                                                  |
|                                                                                                  |
|                                                                                                  |
|                                                                                                  |
|                                                                                                  |
|                                                                                                  |
|                                                                                                  |
|                                                                      ■                           |
|                                                                  ■   ■                           |
|                          ▲    ▲▲    ▲▲▲                      ■   ■   ■                           |
|##################################################################################################|