|##################################################################################################|
|                                                                                                  |
|                                                                                                  |
|                                                                                                  |
|                                                                                                  |
|   □                             ▲          ▲▲          ▲▲▲                                       |
|##################################################################################################|