|##################################################################################################|
|                                                                                                  |
|                                                                                                  |
|                                                                                                  |
|                                                                                                  |
|   □                    ▲▲▲          ▲▲▲           ▲▲▲▲▲▲                                         |
|##################################################################################################|