|##################################################################################################|
|                                                                                                  |
|                                                                                                  |
|                                                                                                  |
|                                                                                                  |
|                                                                                                  |
|                                                                                                  |
|                                                                                                  |
|                                                                                                  |
|                                                                                                  |
|                                                                                  ■               |
|                                                                           ■      ■               |
| □          ▲          ▲▲          ▲▲▲                                ■    ■      ■               |
|##################################################################################################|