|####################################################################################################################################################################################################|
|                                                                                                                                                                                                    |
|                                                                                                                                                                                                    |
|                                                                                                                                                                                                    |
|                                                                                                                                                                                                    |
| □                  ▲          ▲▲          ▲▲▲          ▲▲▲▲       ▲▲▲▲       ▲▲▲▲       ▲▲▲▲       ▲▲▲▲       ▲▲▲▲       ▲▲▲▲       ▲▲▲▲       ▲▲▲▲       ▲▲▲▲       ▲▲▲▲                          |
|####################################################################################################################################################################################################|